NULL
The	DT	_ <O>
'	``	_ <O>
Upper	NNP	_ <O>
West	NNP	_ <O>
Side	NNP	_ <O>
'	''	_ <O>
is	VBZ	_ <O>
a	DT	_ <O>
neighborhood	NN	_ <O>
of	IN	_ <O>
the	DT	_ <O>
<unk>	NN	_ <O>
of	IN	_ <O>
Manhattan	NNP	_ <O>
in	IN	_ <O>
New	NNP	_ <O>
York	NNP	_ <O>
City	NNP	_ <O>
that	WDT	_ <O>
lies	VBZ	_ <O>
between	IN	_ <O>
Central	NNP	_ <O>
Park	NNP	_ <O>
and	CC	_ <O>
the	DT	_ <O>
<unk>	NNP	_ <O>
River	NNP	_ <O>
above	IN	_ <O>
West	NNP	_ <O>
<unk>	JJ	_ <O>
Street	NNP	_ <O>
.	.	_ <O>

NULL
