NULL
Together	RB	_ <O>
with	IN	_ <O>
the	DT	_ <O>
6th	NNP	_ <O>
Battalion	NNP	_ <O>
of	IN	_ <O>
the	DT	_ <O>
Bedfordshire	NNP	_ <O>
and	CC	_ <O>
Hertfordshire	NNP	_ <O>
Regiment	NNP	_ <O>
,	,	_ <O>
they	PRP	_ <O>
made	VBD	_ <O>
up	RP	_ <O>
162nd	NNP	_ <O>
Infantry	NNP	_ <O>
Brigade	NNP	_ <O>
of	IN	_ <O>
the	DT	_ <O>
East	NNP	_ <O>
Anglian	NNP	_ <O>
Division	NNP	_ <O>
.	.	_ <O>

NULL
