The	DT	_ <O>
final	JJ	_ <O>
results	NNS	_ <O>
amongst	IN	_ <O>
these	DT	_ <O>
supply	NN	_ <O>
and	CC	_ <O>
demand	NN	_ <O>
<unk>	NNS	_ <O>
is	VBZ	_ <O>
a	DT	_ <O>
<unk>	NN	_ <O>
of	IN	_ <O>
different	JJ	_ <O>
<unk>	NNS	_ <O>
representing	VBG	_ <O>
income	NN	_ <O>
inequality	NN	_ <O>
within	IN	_ <O>
society	NN	_ <O>
.	.	_ <O>

NULL
