NULL
Swords	NNS	_ <O>
were	VBD	_ <O>
kept	VBN	_ <O>
in	IN	_ <O>
sheaths	NNS	_ <O>
,	,	_ <O>
some	DT	_ <O>
of	IN	_ <O>
which	WDT	_ <O>
,	,	_ <O>
depending	VBG	_ <O>
on	IN	_ <O>
status	NN	_ <O>
,	,	_ <O>
were	VBD	_ <O>
very	RB	_ <O>
ornate	JJ	_ <O>
.	.	_ <O>
 <O>
The	DT	_ <O>
long	JJ	_ <O>
and	CC	_ <O>
narrow	JJ	_ <O>
swords	NNS	_ <O>
,	,	_ <O>
better	RBR	_ <O>
suited	VBN	_ <O>
for	IN	_ <O>
horseback	NN	_ <O>
combat	NN	_ <O>
,	,	_ <O>
became	VBD	_ <O>
popular	JJ	_ <O>
again	RB	_ <O>
in	IN	_ <O>
the	DT	_ <O>
3rd	JJ	_ <O>
century	NN	_ <O>
,	,	_ <O>
but	CC	_ <O>
only	RB	_ <O>
the	DT	_ <O>
more	RBR	_ <O>
wealthy	JJ	_ <O>
warriors	NNS	_ <O>
had	VBD	_ <O>
horses	NNS	_ <O>
,	,	_ <O>
nor	CC	_ <O>
to	TO	_ <O>
mention	VB	_ <O>
iron	NN	_ <O>
helmets	NNS	_ <O>
or	CC	_ <O>
ring	NN	_ <O>
armor	NN	_ <O>
.	.	_ <O>
 <O>
Round	JJ	_ <O>
wooden	JJ	_ <O>
shields	NNS	_ <O>
had	VBD	_ <O>
iron	NN	_ <O>
umbos	NN	_ <O>
in	IN	_ <O>
the	DT	_ <O>
middle	NN	_ <O>
,	,	_ <O>
usually	RB	_ <O>
with	IN	_ <O>
a	DT	_ <O>
thorn	NN	_ <O>
for	IN	_ <O>
piercing	VBG	_ <O>
the	DT	_ <O>
enemy	NN	_ <O>
.	.	_ <O>
 <O>
Numerous	JJ	_ <O>
Przeworsk	NNP	_ <O>
culture	NN	_ <O>
objects	VBZ	_ <O>
including	VBG	_ <O>
spurs	NNS	_ <O>
and	CC	_ <O>
a	DT	_ <O>
unique	JJ	_ <O>
silver	NN	_ <O>
belt	NN	_ <O>
buckle	NN	_ <O>
were	VBD	_ <O>
recovered	VBN	_ <O>
at	IN	_ <O>
the	DT	_ <O>
Aleksandrowice	NNP	_ <O>
,	,	_ <O>
Krak√≥w	NNP	_ <O>
County	NNP	_ <O>
settlement	NN	_ <O>
area	NN	_ <O>
;	:	_ <O>
some	DT	<B-CUE>
relics	NNS	<I-CUE>
there	EX	_ <O>
are	VBP	_ <O>
dated	VBN	_ <O>
possibly	RB	<B-CUE>
as	RB	_ <O>
late	RB	_ <O>
as	IN	_ <O>
the	DT	_ <O>
first	JJ	_ <O>
half	NN	_ <O>
of	IN	_ <O>
6th	JJ	_ <O>
century	NN	_ <O>
.	.	_ <O>
 <O>
