NULL
Groups	NNS	<B-CUE>
such	JJ	_ <O>
as	IN	_ <O>
Defeat	NNP	_ <O>
Autism	NNP	_ <O>
Now	RB	_ <O>
contend	VB	_ <O>
that	IN	_ <O>
autism	NN	_ <O>
is	VBZ	_ <O>
caused	VBN	_ <O>
by	IN	_ <O>
heavy	JJ	_ <O>
metal	NN	_ <O>
toxicity	NN	_ <O>
,	,	_ <O>
and	CC	_ <O>
use	VB	_ <O>
chelation	NN	_ <O>
therapy	NN	_ <O>
to	TO	_ <O>
remove	VB	_ <O>
the	DT	_ <O>
minerals	NNS	_ <O>
from	IN	_ <O>
the	DT	_ <O>
blood	NN	_ <O>
(	-LRB-	_ <O>
though	IN	_ <O>
this	DT	_ <O>
also	RB	_ <O>
has	VBZ	_ <O>
never	RB	_ <O>
been	VBN	_ <O>
proven	VBN	_ <O>
to	TO	_ <O>
alleviate	VB	_ <O>
the	DT	_ <O>
symptoms	NNS	_ <O>
of	IN	_ <O>
autism	NN	_ <O>
)	-RRB-	_ <O>
.	.	_ <O>
 <O>
