Rebuffat	NNP	_ <O>
also	RB	_ <O>
was	VBD	_ <O>
second	JJ	_ <O>
unit	NN	_ <O>
director	NN	_ <O>
on	IN	_ <O>
the	DT	_ <O>
Walt	NNP	_ <O>
Disney	NNP	_ <O>
mountain	NN	_ <O>
film	NN	_ <O>
'	''	_ <O>
Third	NNP	_ <O>
Man	NNP	_ <O>
on	IN	_ <O>
the	DT	_ <O>
Mountain	NNP	_ <O>
'	''	_ <O>
.	.	_ <O>
 <O>
