In	IN	_ <O>
addition	NN	_ <O>
,	,	_ <O>
Lazio	NNP	_ <O>
won	VBD	_ <O>
the	DT	_ <O>
Italian	JJ	_ <O>
Super	NNP	_ <O>
Cup	NNP	_ <O>
twice	RB	_ <O>
and	CC	_ <O>
defeated	VBN	_ <O>
Manchester	NNP	_ <O>
United	NNP	_ <O>
in	IN	_ <O>
1999	CD	_ <O>
to	TO	_ <O>
win	VB	_ <O>
the	DT	_ <O>
European	JJ	_ <O>
Super	NNP	_ <O>
Cup	NNP	_ <O>
.	.	_ <O>
 <O>
